Bulbasaur	Monster	Grass
Ivysaur	Monster	Grass
Venusaur	Monster	Grass
Charmander	Monster	Dragon
Charmeleon	Monster	Dragon
Charizard	Monster	Dragon
Squirtle	Monster	Water1
Wartortle	Monster	Water1
Blastoise	Monster	Water1
Caterpie	Bug	
Metapod	Bug	
Butterfree	Bug	
Weedle	Bug	
Kakuna	Bug	
Beedrill	Bug	
Pidgey	Flying	
Pidgeotto	Flying	
Pidgeot	Flying	
Rattata	Field	
Raticate	Field	
Spearow	Flying	
Fearow	Flying	
Ekans	Field	Dragon
Arbok	Field	Dragon
Pikachu	Field	Fairy
Raichu	Field	Fairy
Sandshrew	Field	
Sandslash	Field	
Nidoran F	Monster	Field
Nidorina	Undiscovered	
Nidoqueen	Undiscovered	
Nidoran M	Monster	Field
Nidorino	Monster	Field
Nidoking	Monster	Field
Clefairy	Fairy	
Clefable	Fairy	
Vulpix	Field	
Ninetales	Field	
Jigglypuff	Fairy	
Wigglytuff	Fairy	
Zubat	Flying	
Golbat	Flying	
Oddish	Grass	
Gloom	Grass	
Vileplume	Grass	
Paras	Bug	Grass
Parasect	Bug	Grass
Venonat	Bug	
Venomoth	Bug	
Diglett	Field	
Dugtrio	Field	
Meowth	Field	
Persian	Field	
Psyduck	Water1	Field
Golduck	Water1	Field
Mankey	Field	
Primeape	Field	
Growlithe	Field	
Arcanine	Field	
Poliwag	Water1	
Poliwhirl	Water1	
Poliwrath	Water1	
Abra	Human-Like	
Kadabra	Human-Like	
Alakazam	Human-Like	
Machop	Human-Like	
Machoke	Human-Like	
Machamp	Human-Like	
Bellsprout	Grass	
Weepinbell	Grass	
Victreebel	Grass	
Tentacool	Water3	
Tentacruel	Water3	
Geodude	Mineral	
Graveler	Mineral	
Golem	Mineral	
Ponyta	Field	
Rapidash	Field	
Slowpoke	Monster	Water1
Slowbro	Monster	Water1
Magnemite	Mineral	
Magneton	Mineral	
Farfetch'd	Flying	Field
Doduo	Flying	
Dodrio	Flying	
Seel	Water1	Field
Dewgong	Water1	Field
Grimer	Amorphous	
Muk	Amorphous	
Shellder	Water3	
Cloyster	Water3	
Gastly	Amorphous	
Haunter	Amorphous	
Gengar	Amorphous	
Onix	Mineral	
Drowzee	Human-Like	
Hypno	Human-Like	
Krabby	Water3	
Kingler	Water3	
Voltorb	Mineral	
Electrode	Mineral	
Exeggcute	Grass	
Exeggutor	Grass	
Cubone	Monster	
Marowak	Monster	
Hitmonlee	Human-Like	
Hitmonchan	Human-Like	
Lickitung	Monster	
Koffing	Amorphous	
Weezing	Amorphous	
Rhyhorn	Monster	Field
Rhydon	Monster	Field
Chansey	Fairy	
Tangela	Grass	
Kangaskhan	Monster	
Horsea	Water1	Dragon
Seadra	Water1	Dragon
Goldeen	Water2	
Seaking	Water2	
Staryu	Water3	
Starmie	Water3	
Mr. Mime	Human-Like	
Scyther	Bug	
Jynx	Human-Like	
Electabuzz	Human-Like	
Magmar	Human-Like	
Pinsir	Bug	
Tauros	Field	
Magikarp	Water2	Dragon
Gyarados	Water2	Dragon
Lapras	Monster	Water1
Ditto	Ditto	
Eevee	Field	
Vaporeon	Field	
Jolteon	Field	
Flareon	Field	
Porygon	Mineral	
Omanyte	Water1	Water3
Omastar	Water1	Water3
Kabuto	Water1	Water3
Kabutops	Water1	Water3
Aerodactyl	Flying	
Snorlax	Monster	
Articuno	Undiscovered	
Zapdos	Undiscovered	
Moltres	Undiscovered	
Dratini	Water1	Dragon
Dragonair	Water1	Dragon
Dragonite	Water1	Dragon
Mewtwo	Undiscovered	
Mew	Undiscovered	
Chikorita	Monster	Grass
Bayleef	Monster	Grass
Meganium	Monster	Grass
Cyndaquil	Field	
Quilava	Field	
Typhlosion	Field	
Totodile	Monster	Water1
Croconaw	Monster	Water1
Feraligatr	Monster	Water1
Sentret	Field	
Furret	Field	
Hoothoot	Flying	
Noctowl	Flying	
Ledyba	Bug	
Ledian	Bug	
Spinarak	Bug	
Ariados	Bug	
Crobat	Flying	
Chinchou	Water2	
Lanturn	Water2	
Pichu	Undiscovered	
Cleffa	Undiscovered	
Igglybuff	Undiscovered	
Togepi	Undiscovered	
Togetic	Flying	Fairy
Natu	Flying	
Xatu	Flying	
Mareep	Monster	Field
Flaaffy	Monster	Field
Ampharos	Monster	Field
Bellossom	Grass	
Marill	Water1	Fairy
Azumarill	Water1	Fairy
Sudowoodo	Mineral	
Politoed	Water1	
Hoppip	Fairy	Grass
Skiploom	Fairy	Grass
Jumpluff	Fairy	Grass
Aipom	Field	
Sunkern	Grass	
Sunflora	Grass	
Yanma	Bug	
Wooper	Water1	Field
Quagsire	Water1	Field
Espeon	Field	
Umbreon	Field	
Murkrow	Flying	
Slowking	Monster	Water1
Misdreavus	Amorphous	
Unown	Undiscovered	
Wobbuffet	Amorphous	
Girafarig	Field	
Pineco	Bug	
Forretress	Bug	
Dunsparce	Field	
Gligar	Bug	
Steelix	Mineral	
Snubbull	Field	Fairy
Granbull	Field	Fairy
Qwilfish	Water2	
Scizor	Bug	
Shuckle	Bug	
Heracross	Bug	
Sneasel	Field	
Teddiursa	Field	
Ursaring	Field	
Slugma	Amorphous	
Magcargo	Amorphous	
Swinub	Field	
Piloswine	Field	
Corsola	Water1	Water3
Remoraid	Water1	Water2
Octillery	Water1	Water2
Delibird	Water1	Field
Mantine	Water1	
Skarmory	Flying	
Houndour	Field	
Houndoom	Field	
Kingdra	Water1	Dragon
Phanpy	Field	
Donphan	Field	
Porygon2	Mineral	
Stantler	Field	
Smeargle	Field	
Tyrogue	Undiscovered	
Hitmontop	Human-Like	
Smoochum	Undiscovered	
Elekid	Undiscovered	
Magby	Undiscovered	
Miltank	Field	
Blissey	Fairy	
Raikou	Undiscovered	
Entei	Undiscovered	
Suicune	Undiscovered	
Larvitar	Monster	
Pupitar	Monster	
Tyranitar	Monster	
Lugia	Undiscovered	
Ho-Oh	Undiscovered	
Celebi	Undiscovered	
Treecko	Monster	Dragon
Grovyle	Monster	Dragon
Sceptile	Monster	Dragon
Torchic	Field	
Combusken	Field	
Blaziken	Field	
Mudkip	Monster	Water1
Marshtomp	Monster	Water1
Swampert	Monster	Water1
Poochyena	Field	
Mightyena	Field	
Zigzagoon	Field	
Linoone	Field	
Wurmple	Bug	
Silcoon	Bug	
Beautifly	Bug	
Cascoon	Bug	
Dustox	Bug	
Lotad	Water1	Grass
Lombre	Water1	Grass
Ludicolo	Water1	Grass
Seedot	Field	Grass
Nuzleaf	Field	Grass
Shiftry	Field	Grass
Taillow	Flying	
Swellow	Flying	
Wingull	Water1	Flying
Pelipper	Water1	Flying
Ralts	Amorphous	
Kirlia	Amorphous	
Gardevoir	Amorphous	
Surskit	Water1	Bug
Masquerain	Water1	Bug
Shroomish	Fairy	Grass
Breloom	Fairy	Grass
Slakoth	Field	
Vigoroth	Field	
Slaking	Field	
Nincada	Bug	
Ninjask	Bug	
Shedinja	Mineral	
Whismur	Monster	Field
Loudred	Monster	Field
Exploud	Monster	Field
Makuhita	Human-Like	
Hariyama	Human-Like	
Azurill	Undiscovered	
Nosepass	Mineral	
Skitty	Field	Fairy
Delcatty	Field	Fairy
Sableye	Human-Like	
Mawile	Field	Fairy
Aron	Monster	
Lairon	Monster	
Aggron	Monster	
Meditite	Human-Like	
Medicham	Human-Like	
Electrike	Field	
Manectric	Field	
Plusle	Fairy	
Minun	Fairy	
Volbeat	Bug	Human-Like
Illumise	Bug	Human-Like
Roselia	Fairy	Grass
Gulpin	Amorphous	
Swalot	Amorphous	
Carvanha	Water2	
Sharpedo	Water2	
Wailmer	Field	Water2
Wailord	Field	Water2
Numel	Field	
Camerupt	Field	
Torkoal	Field	
Spoink	Field	
Grumpig	Field	
Spinda	Field	Human-Like
Trapinch	Bug	
Vibrava	Bug	
Flygon	Bug	
Cacnea	Grass	Human-Like
Cacturne	Grass	Human-Like
Swablu	Flying	Dragon
Altaria	Flying	Dragon
Zangoose	Field	
Seviper	Field	Dragon
Lunatone	Mineral	
Solrock	Mineral	
Barboach	Water2	
Whiscash	Water2	
Corphish	Water1	Water3
Crawdaunt	Water1	Water3
Baltoy	Mineral	
Claydol	Mineral	
Lileep	Water3	
Cradily	Water3	
Anorith	Water3	
Armaldo	Water3	
Feebas	Water1	Dragon
Milotic	Water1	Dragon
Castform	Fairy	Amorphous
Kecleon	Field	
Shuppet	Amorphous	
Banette	Amorphous	
Duskull	Amorphous	
Dusclops	Amorphous	
Tropius	Monster	Grass
Chimecho	Amorphous	
Absol	Field	
Wynaut	Undiscovered	
Snorunt	Fairy	Mineral
Glalie	Fairy	Mineral
Spheal	Water1	Field
Sealeo	Water1	Field
Walrein	Water1	Field
Clamperl	Water1	
Huntail	Water1	
Gorebyss	Water1	
Relicanth	Water1	Water2
Luvdisc	Water2	
Bagon	Dragon	
Shelgon	Dragon	
Salamence	Dragon	
Beldum	Mineral	
Metang	Mineral	
Metagross	Mineral	
Regirock	Undiscovered	
Regice	Undiscovered	
Registeel	Undiscovered	
Latias	Undiscovered	
Latios	Undiscovered	
Kyogre	Undiscovered	
Groudon	Undiscovered	
Rayquaza	Undiscovered	
Jirachi	Undiscovered	
Deoxys	Undiscovered	
Turtwig	Monster	Grass
Grotle	Monster	Grass
Torterra	Monster	Grass
Chimchar	Field	Human-Like
Monferno	Field	Human-Like
Infernape	Field	Human-Like
Piplup	Water1	Field
Prinplup	Water1	Field
Empoleon	Water1	Field
Starly	Flying	
Staravia	Flying	
Staraptor	Flying	
Bidoof	Water1	Field
Bibarel	Water1	Field
Kricketot	Bug	
Kricketune	Bug	
Shinx	Field	
Luxio	Field	
Luxray	Field	
Budew	Undiscovered	
Roserade	Fairy	Grass
Cranidos	Monster	
Rampardos	Monster	
Shieldon	Monster	
Bastiodon	Monster	
Burmy	Bug	
Wormadam	Bug	
Mothim	Bug	
Combee	Bug	
Vespiquen	Bug	
Pachirisu	Field	Fairy
Buizel	Water1	Field
Floatzel	Water1	Field
Cherubi	Fairy	Grass
Cherrim	Fairy	Grass
Shellos	Water1	Amorphous
Gastrodon	Water1	Amorphous
Ambipom	Field	
Drifloon	Amorphous	
Drifblim	Amorphous	
Buneary	Field	Human-Like
Lopunny	Field	Human-Like
Mismagius	Amorphous	
Honchkrow	Flying	
Glameow	Field	
Purugly	Field	
Chingling	Undiscovered	
Stunky	Field	
Skuntank	Field	
Bronzor	Mineral	
Bronzong	Mineral	
Bonsly	Undiscovered	
Mime Jr.	Undiscovered	
Happiny	Undiscovered	
Chatot	Flying	
Spiritomb	Amorphous	
Gible	Monster	Dragon
Gabite	Monster	Dragon
Garchomp	Monster	Dragon
Munchlax	Undiscovered	
Riolu	Undiscovered	
Lucario	Field	Human-Like
Hippopotas	Field	
Hippowdon	Field	
Skorupi	Bug	Water3
Drapion	Bug	Water3
Croagunk	Human-Like	
Toxicroak	Human-Like	
Carnivine	Grass	
Finneon	Water2	
Lumineon	Water2	
Mantyke	Undiscovered	
Snover	Monster	Grass
Abomasnow	Monster	Grass
Weavile	Field	
Magnezone	Mineral	
Lickilicky	Monster	
Rhyperior	Monster	Field
Tangrowth	Grass	
Electivire	Human-Like	
Magmortar	Human-Like	
Togekiss	Flying	Fairy
Yanmega	Bug	
Leafeon	Field	
Glaceon	Field	
Gliscor	Bug	
Mamoswine	Field	
Porygon-Z	Mineral	
Gallade	Amorphous	
Probopass	Mineral	
Dusknoir	Amorphous	
Froslass	Fairy	Mineral
Rotom	Amorphous	
Uxie	Undiscovered	
Mesprit	Undiscovered	
Azelf	Undiscovered	
Dialga	Undiscovered	
Palkia	Undiscovered	
Heatran	Undiscovered	
Regigigas	Undiscovered	
Giratina	Undiscovered	
Cresselia	Undiscovered	
Phione	Water1	Fairy
Manaphy	Water1	Fairy
Darkrai	Undiscovered	
Shaymin	Undiscovered	
Arceus	Undiscovered	
Victini	Undiscovered	
Snivy	Field	Grass
Servine	Field	Grass
Serperior	Field	Grass
Tepig	Field	
Pignite	Field	
Emboar	Field	
Oshawott	Field	
Dewott	Field	
Samurott	Field	
Patrat	Field	
Watchog	Field	
Lillipup	Field	
Herdier	Field	
Stoutland	Field	
Purrloin	Field	
Liepard	Field	
Pansage	Field	
Simisage	Field	
Pansear	Field	
Simisear	Field	
Panpour	Field	
Simipour	Field	
Munna	Field	
Musharna	Field	
Pidove	Flying	
Tranquill	Flying	
Unfezant	Flying	
Blitzle	Field	
Zebstrika	Field	
Roggenrola	Mineral	
Boldore	Mineral	
Gigalith	Mineral	
Woobat	Field	Flying
Swoobat	Field	Flying
Drilbur	Field	
Excadrill	Field	
Audino	Fairy	
Timburr	Human-Like	
Gurdurr	Human-Like	
Conkeldurr	Human-Like	
Tympole	Water1	
Palpitoad	Water1	
Seismitoad	Water1	
Throh	Human-Like	
Sawk	Human-Like	
Sewaddle	Bug	
Swadloon	Bug	
Leavanny	Bug	
Venipede	Bug	
Whirlipede	Bug	
Scolipede	Bug	
Cottonee	Grass	Fairy
Whimsicott	Grass	Fairy
Petilil	Grass	
Lilligant	Grass	
Basculin	Water2	
Sandile	Field	
Krokorok	Field	
Krookodile	Field	
Darumaka	Field	
Darmanitan	Field	
Maractus	Grass	
Dwebble	Bug	Mineral
Crustle	Bug	Mineral
Scraggy	Field	Dragon
Scrafty	Field	Dragon
Sigilyph	Flying	
Yamask	Mineral	Amorphous
Cofagrigus	Mineral	Amorphous
Tirtouga	Water1	Water3
Carracosta	Water1	Water3
Archen	Flying	Water3
Archeops	Flying	Water3
Trubbish	Mineral	
Garbodor	Mineral	
Zorua	Field	
Zoroark	Field	
Minccino	Field	
Cinccino	Field	
Gothita	Human-Like	
Gothorita	Human-Like	
Gothitelle	Human-Like	
Solosis	Amorphous	
Duosion	Amorphous	
Reuniclus	Amorphous	
Ducklett	Water1	Flying
Swanna	Water1	Flying
Vanillite	Mineral	
Vanillish	Mineral	
Vanilluxe	Mineral	
Deerling	Field	
Sawsbuck	Field	
Emolga	Field	
Karrablast	Bug	
Escavalier	Bug	
Foongus	Grass	
Amoonguss	Grass	
Frillish	Amorphous	
Jellicent	Amorphous	
Alomomola	Water1	Water2
Joltik	Bug	
Galvantula	Bug	
Ferroseed	Grass	Mineral
Ferrothorn	Grass	Mineral
Klink	Mineral	
Klang	Mineral	
Klinklang	Mineral	
Tynamo	Amorphous	
Eelektrik	Amorphous	
Eelektross	Amorphous	
Elgyem	Human-Like	
Beheeyem	Human-Like	
Litwick	Amorphous	
Lampent	Amorphous	
Chandelure	Amorphous	
Axew	Monster	Dragon
Fraxure	Monster	Dragon
Haxorus	Monster	Dragon
Cubchoo	Field	
Beartic	Field	
Cryogonal	Mineral	
Shelmet	Bug	
Accelgor	Bug	
Stunfisk	Water1	Amorphous
Mienfoo	Field	Human-Like
Mienshao	Field	Human-Like
Druddigon	Dragon	Monster
Golett	Mineral	
Golurk	Mineral	
Pawniard	Human-Like	
Bisharp	Human-Like	
Bouffalant	Field	
Rufflet	Flying	
Braviary	Flying	
Vullaby	Flying	
Mandibuzz	Flying	
Heatmor	Field	
Durant	Bug	
Deino	Dragon	
Zweilous	Dragon	
Hydreigon	Dragon	
Larvesta	Bug	
Volcarona	Bug	
Cobalion	Undiscovered	
Terrakion	Undiscovered	
Virizion	Undiscovered	
Tornadus	Undiscovered	
Thundurus	Undiscovered	
Reshiram	Undiscovered	
Zekrom	Undiscovered	
Landorus	Undiscovered	
Kyurem	Undiscovered	
Keldeo	Undiscovered	
Meloetta	Undiscovered	
Genesect	Undiscovered	
Chespin	Field	
Quilladin	Field	
Chesnaught	Field	
Fennekin	Field	
Braixen	Field	
Delphox	Field	
Froakie	Water1	
Frogadier	Water1	
Greninja	Water1	
Bunnelby	Field	
Diggersby	Field	
Fletchling	Flying	
Fletchinder	Flying	
Talonflame	Flying	
Scatterbug	Bug	
Spewpa	Bug	
Vivillon	Bug	
Litleo	Field	
Pyroar	Field	
Flabébé	Fairy	
Floette	Fairy	
Florges	Fairy	
Skiddo	Field	
Gogoat	Field	
Pancham	Field	Human-Like
Pangoro	Field	Human-Like
Furfrou	Field	
Espurr	Field	
Meowstic	Field	
Honedge	Mineral	
Doublade	Mineral	
Aegislash	Mineral	
Spritzee	Fairy	
Aromatisse	Fairy	
Swirlix	Fairy	
Slurpuff	Fairy	
Inkay	Water1	Water2
Malamar	Water1	Water2
Binacle	Water3	
Barbaracle	Water3	
Skrelp	Water1	Dragon
Dragalge	Water1	Dragon
Clauncher	Water1	Water3
Clawitzer	Water1	Water3
Helioptile	Monster	Dragon
Heliolisk	Monster	Dragon
Tyrunt	Monster	Dragon
Tyrantrum	Monster	Dragon
Amaura	Monster	
Aurorus	Monster	
Sylveon	Field	
Hawlucha	Human-Like	
Dedenne	Field	Fairy
Carbink	Fairy	Mineral
Goomy	Dragon	
Sliggoo	Dragon	
Goodra	Dragon	
Klefki	Mineral	
Phantump	Grass	Amorphous
Trevenant	Grass	Amorphous
Pumpkaboo	Amorphous	
Gourgeist	Amorphous	
Bergmite	Monster	
Avalugg	Monster	
Noibat	Flying	
Noivern	Flying	
Xerneas	Undiscovered	
Yveltal	Undiscovered	
Zygarde	Undiscovered	
Diancie	Undiscovered	
Hoopa	Undiscovered	
Volcanion	Undiscovered	
Rowlet	Flying	
Dartrix	Flying	
Decidueye	Flying	
Litten	Field	
Torracat	Field	
Incineroar	Field	
Popplio	Water1	Field
Brionne	Water1	Field
Primarina	Water1	Field
Pikipek	Flying	
Trumbeak	Flying	
Toucannon	Flying	
Yungoos	Field	
Gumshoos	Field	
Grubbin	Bug	
Charjabug	Bug	
Vikavolt	Bug	
Crabrawler	Water3	
Crabominable	Water3	
Oricorio	Flying	
Cutiefly	Bug	Fairy
Ribombee	Bug	Fairy
Rockruff	Field	
Lycanroc	Field	
Wishiwashi	Water2	
Mareanie	Water1	
Toxapex	Water1	
Mudbray	Field	
Mudsdale	Field	
Dewpider	Water1	Bug
Araquanid	Water1	Bug
Fomantis	Grass	
Lurantis	Grass	
Morelull	Grass	
Shiinotic	Grass	
Salandit	Monster	Dragon
Salazzle	Monster	Dragon
Stufful	Field	
Bewear	Field	
Bounsweet	Grass	
Steenee	Grass	
Tsareena	Grass	
Comfey	Grass	
Oranguru	Field	
Passimian	Field	
Wimpod	Bug	Water3
Golisopod	Bug	Water3
Sandygast	Amorphous	
Palossand	Amorphous	
Pyukumuku	Water1	
Type:Null	Undiscovered	
Silvally	Undiscovered	
Minior	Mineral	
Komala	Field	
Turtonator	Monster	Dragon
Togedemaru	Field	Fairy
Mimikyu	Amorphous	
Bruxish	Water2	
Drampa	Monster	Dragon
Dhelmise	Mineral	
Jangmo-o	Dragon	
Hakamo-o	Dragon	
Kommo-o	Dragon	
TapuKoko	Undiscovered	
TapuLele	Undiscovered	
TapuBulu	Undiscovered	
TapuFini	Undiscovered	
Cosmog	Undiscovered	
Cosmoem	Undiscovered	
Solgaleo	Undiscovered	
Lunala	Undiscovered	
Nihilego	Undiscovered	
Buzzwole	Undiscovered	
Pheromosa	Undiscovered	
Xurkitree	Undiscovered	
Celesteela	Undiscovered	
Kartana	Undiscovered	
Guzzlord	Undiscovered	
Necrozma	Undiscovered	
Magearna	Undiscovered	
Marshadow	Undiscovered	
Poipole	Undiscovered	
Naganadel	Undiscovered	
Stakataka	Undiscovered	
Blacephalon	Undiscovered	
Zeraora	Undiscovered	